wwwwwwwwddwwwwwwww
w0000000000000000w
w000www0000www000w
w00wwwww00wwwww00w
w000www0h00www000w
w0000000000000000w
w000www0000www000w
w00wwwww00wwwww00d
w000www0h00www0g0w
w0000000000000000w
w000www0000www000w
w00wwwww00wwwww00w
w000www0h00www000w
w0000000000000000w
wwwwwwwwwwwwwwwwww