wwwwwwwwwwwwwwwwww
w0000000000000000w
w0000000000000000w
w000www0000www000w
w0000000000000000w
w00000www0000www0w
w0000000000000000w
d000www00000www00d
w0000000000000000w
w00000www0000www0w
w0000000000000000w
w000www00000www00w
w0000000000000000w
w0000000000000000w
wwwwwwwwwwwwwwwwww