wwwwwwwwwwwwwwwwww
w000g000000000000w
w0000000000000000w
w00wwwww00wwwww00w
w00w00h0000000w00w
w00w0000000t00w00w
w00wwwww00wwwww00w
w0000000000000000d
w00wwwwwwwwwwww00w
w000000w00w000000w
w000000w00w0h0000w
w00wwwww00wwwww00w
w0000000000000g00w
w0000000000000000w
wwwwwwwwddwwwwwwww