wwwwwwwwwwwwwwwwww
w00g000wwww000000w
w000000000000g000w
w000www00h0www000w
w00e0000000000000w
w00000www0www0000w
w0000000000000000w
d000www00h00www00d
w0000000000000000w
w00000www0www0000w
w000e000000000000w
w000www00000www00w
w0000000000000000w
w000000wwww000000w
wwwwwwwwwwwwwwwwww