wwwwwwwwwwwwwwwwww
w0000w00000000000w
w0000w00000000000w
w0000w00000000000w
w0000w00000000000w
w0000w00000000000w
w0000000000000000w
w0000000w00000000d
w0000000w0000g000w
w0000000w00000000w
w0000000w0000e000w
w0000000000000000w
w0000000000000000w
w0000000000000000w
wwwwwwwwwwwwwwwwww