wwwwwwwwwwwwwwwwww
w0000ww0000ww0000w
w0000000000000000w
w00ww00wwww00ww00w
w0000000000000000w
w00wwwww00wwwww00w
w0000000000000w00w
w00w0000000000w00w
w00w0000000000000w
w00ww00wwww00ww00w
w0000000000000000w
w00wwwww00wwwww00w
w0000000000000000w
w000www0000www000w
wwwwwwwwwwwwwwwwww