wwwwwwwwwwwwwwwwww
w0000000000000000w
w0000000000000000w
w00wwwwwwwwwwww00w
w00w0000000000w00w
w00w0000000000w00w
w0000000000000000w
d0000000000000000w
w0000000000000000w
w00w0000000000w00w
w00w0000000000w00w
w00wwwwwwwwwwww00w
w0000000000000000w
w0000000000000000w
wwwwwwwwwwwwwwwwww