wwwwwwwwwwwwwwwwww
w0000000000000000w
w00wwwwwwww00ww00w
w00w000000w000000w
w00w00ww00wwwww00w
w00w00ww000000000w
w00w00wwww000ww00w
w00w00w00ww000w00w
w00000w0000000000w
wwwwwww00wwwwww0ww
w0000w00000w00w00w
w0ww0w0www0000000w
w0ww000w000www00ww
w0000000000w00000w
wwwwwwwwddwwwwwwww