wwwwwwwwwwwwwwwwww
w0000w00000000000w
w0000w00000000000w
w0000w00000000000w
w0000w00000000000w
w0000w00000000000w
w0000000000000000w
w0000000w00000000d
w0000000w00000000w
w0000000w00000000w
w0000000w00000000w
w0000000000000000w
w00000000000t0000w
w0000000000000000w
wwwwwwwwwwwwwwwwww