wwwwwwwwddwwwwwwww
w0000000000000000w
w0000000000000000w
w00wwww0000wwww00w
w00w0000000000w00w
w00w0000000000w00w
w00w0000000000w00w
d0000000000000000w
w00w0000000000w00w
w00w0000000000w00w
w00w0000000000w00w
w00wwww0000wwww00w
w0000000000000000w
w0000000000000000w
wwwwwwwwwwwwwwwwww